1111111111111
10010000000C1
1000011111C11
110011E000001
1111111111111