1111111111
10E0QC0001
1111110101
1101E000P1
1111111111