111111111111111111
1E000000000C000001
1010101C1010000001
1010101C1010000001
1P000000000C000001
111111111111000001